111111111111111111111111111
100100000010000000000000001
100C01111000000C11000010001
110011000000C00000111000001
111000C00001000C00100000001
10000000000000110011000C101
100001110000000C11110000001
1000011111P00000000000E0001
111111111111111111111111111